sm 10 6
cp 5 3
bp 9 4
sp 2 4
ep 9 4
nw 3
l 0 0 0 1 1 2 1 1 1 2
l 0 2 0 0 0 1 0 0 0 2
l 0 0 1 1 0 0 0 1 0 1
l 1 0 2 2 1 1 1 2 0 2
l 2 2 2 2 2 2 2 2 2 2
l 2 2 2 2 2 2 2 2 2 2